-23
23
-11
11
00000000000000000000000000000000000000000000000
11111111111111111111111111111111111111111111110
00000000000000000000000000000000000000000000000
00000000000000000000000000000000000000000000000
00000000000000000000000000000000000000000000000
00000000000000000000000000000000000000100000000
00000000000000000000000000000111111100100000000
00000000000000000000000000000111111100000000000
00000000000000000000000000000111111100000000000
00000000000000000000010000000111111100000000000
00000000000000000000000000000111111100000000000
00000000000000000000000000000111111100000000000
00000000000000000001000000000111111100000000000
00000000000000000000000000000000000000000000000
00000000000000000000000000000101000000000000000
00000000000000000000000000000000000000000000000
00000000000000000000000000000000000000000000000
00000000000000000000000000000000000000000000000
00000000000000000000000000000000000000000000000
00000000000000000000000000000000000000000000000
00000000000000000000000000000000000000000000000
00000000000000000000000000000000000000000000000
00000000000000000000000000000000000000000000000
