-4
16
-3
7
000000000000000000000
000000000000000000010
000000000011111110010
000000000011111110000
000000000011111110000
001000000011111110000
000000000011111110000
000000000011111110000
100000000011111110000
000000000000000000000
000000000010100000000
